1111111111111111111111
1000011100000C00000011
10E00R0111C11100000011
10E0000111C11100000011
1111111111111111111111