1111111111111111111111
1P00011100000C00000011
1110000000000000000001
10E0000111C11100000011
1111111111111111111111