1111111111111111111111111
10P0000000100000000000001
100000C00000000C000000001
1000000000C0000000E000001
1000000000001100000000001
1000000010000000000000001
1111111111111111111111111