1111111111111111
1P00000000000011
1011101111100101
10C0000000000001
1011101011101011
10000000000E0001
1111111111111111
