1111111111111111111111111111
10P0000000100000000000000011
100000C00000000C000000000011
1000000000C0000000E000000011
1000000000001100000000000011
1000000010000000000000000011
1111111111111111111111111111
